##########
#A...#***#
#*##.#*#K#
#****#*#,#
####***#,#
#......#E#
##########