##########
#A...#...#
#.##.#.#K#
#....#.#.#
####...#.#
#......#E#
##########
